 -----------------------------------
|...........|.|.|.|.................|
|.-.|.|.-.-.|.|.|.|.|.-.|.-.-.-.|.-.|
|...|...|.......|...|...|...........|
|.|-|.-.---.-.--|.-.|-|.---.|.|.----|
|...................................|
|--.-.|.-.--|.|.|.-.|.|-|.|.---.---.|
|...............|.........|.........|
|.|.|.---.|.|.|.-.|.--|.|.|.|.|.|.--|
|...........|.|...|.....|.....|.|...|
|.-.|.|.|.|.---.---.---.|.|.--|.-.|.|
|.|.|.|.|.|...................|...|.|
|.-.--|.|.|--.|.|---|.|.|.-.|.|--.-.|
|.........|...........|.|.....|.....|
|.|.---.|.-.-.|.|.|--.|.|.--|.---.|.|
|...|...|.....|.|.......|.......|...|
|.-.|.-.--|.--|.|----.|.--|.-.|.|.|.|
|.............|...|...........|...|.|
|.-.--|.--|.-.|.-.-.|.|.-.|.|.-.-.-.|
|.....|...|.........|...............|
 -----------------------------------