-------------------------------------
|...........|...|.|...|.|.|.|.|.|...|
|.|.--------|.|.|.|.--|.|.|.|.|.|.--|
|.|...|.|...|.|.|.|.......|.|.|...|.|
|.----|.---.|.--|.|.------|.|.|.--|.|
|.........|.........|.|...|.|.|.....|
|.--------|.--------|.|.--|.|.|.----|
|.................|.......|.....|.|.|
|--.--|.|.----|.--|.|.-----.----|.|.|
|.....|.|.....|.|...|...|...|.......|
|.|.|.--------|.|.----|.---.|.-----.|
|.|.|.........|.......|.........|...|
|----.|.----|.|.|.--------|.--------|
|.....|.....|.|.|.........|.........|
|--.|--.|.--|.|--.|.--|.|.|.|--.|.|.|
|...|...|...|.|...|...|.|.|.|...|.|.|
|.-- --.----|.|--.|.|.|--.|.|.--|.|.|
|...|.......|.|...|.|.|...|.|...|.|..
-------------------------------------