################################################################
###########...........##......#######...########################
#########.....................######....#####...####.###########
######......................#######.....#####....##..###########
######........###..........#######.....####...........##########
######.......####.........#######.....#####............#########
#######.....####......###########....#######.............####.##
########...####...#..############....########.............#....#
###..##....###...################....#######...................#
##.........###...###############......##.......................#
#...........#.....#########.###..................##............#
##................########........................#............#
##................########...................#....###.........##
##...............########........####....#######...####..##..###
#.....###............####.......######...#######...#############
#....#####..........####.......########......###...#############
#...######.........#####......#########.......##....############
##.########........#####....##########.........#....############
#####.....#.........####..#########.................############
#####......##........############.........###.###...############
#####.......#..........##.....###........########....###########
####..........................##...##....########.....##########
###...........................##...###....#######......#########
##...............##...........###..####......####.......#####..#
#.......#........##...........##....####.....###.........###...#
#...######......####...........#.....###.....###..............##
##..######.....####.......................#######....#........##
###..#####....######..#####..............##############.......##
###..####.....############..............################.......#
##....###.....##########.............###################.......#
###..####.....###########..........######################.....##
################################################################