################################################################
##.......#############..####################....##########..####
#.........#####..####.....#################......########....###
#..........###....##.......##########...##........######.....###
#...........................########...............####......###
#...........................#######.................##......####
#.....................#......######.......................######
#....................###.....######........###...........#######
#...................####......####........#####.........########
#............##....###...................######.........########
##..........####..####.............##....#######........########
###.....########..#####...........####..########.........#######
#####..########....####..........##############............#####
##############......##.........###############..............####
#############.......#.......##############....................##
#############....###.....###########...##......................#
##############...###....###########............................#
####......####...##.....#######..........................#.....#
###........###..........#######.............#####.......###....#
##.........###.........########............#######.....####....#
##.....................#######.............#######.....####....#
#.........................####.............#######......##.....#
#..........................###..........##########.............#
#..........................####........############............#
##.........................######......#############...........#
####........................#######...##############..........##
#####...##...##..............######################..........###
#####..#########...............###################..........####
################.................###..###########..........#####
###################.......##..........##########..........######
#####################....####.........###########.......########
################################################################