




     -------------------------------------
     |@..........|...|.|...|.|.|.|.|.|...|
     |#|.--------|.|.|.|.--|.|.|.|.|.|.--|
     |.|...|.|...|.|.|.|.......|.|.|...|.|
     |.----|.---.|.--|.|.------|.|.|.--|.|
     |.........|.........|.|...|.|.|.....|
     |.--------|.--------|.|.--|.|.|.----|
     |.................|.......|.....|.|.|
     |--.--|.|.----|.--|.|.-----.----|.|.|
     |.....|.|.....|.|...|...|...|.......|
     |.|.|.--------|.|.----|.---.|.-----.|
     |.|.|.........|.......|.........|...|
     |----.|.----|.|.|.--------|.--------|
     |.....|.....|.|.|.........|.........|
     |--.|--.|.--|.|--.|.--|.|.|.|--.|.|.|
     |...|...|...|.|...|...|.|.|.|...|.|.|
     |.-- --.----|.|--.|.|.|--.|.|.--|.|.-----|
     |...|.......|.|...|.|.|...|.|...|.|......|
     -----------------------------------------|




                                                       [u] upload-bot
[esc] go-back  [h] help  [spc] pause  [1/2/3] overclock