┌────────────────────────────────── console ───────────────────────────────────┐
│ ; create-world foo --theme arena:radius=8                                    │
│                                                                              │
│ id: 0000-0000-0000-0001                                                      │
│                                                                              │
│ ; create-world zar --theme arena:radius=8                                    │
│                                                                              │
│ id: 0000-0000-0000-0002                                                      │
│                                                                              │
│ ; create-world bar --theme arena:radius=8                                    │
│                                                                              │
│ id: 0000-0000-0000-0003                                                      │
│                                                                              │
│ ; list-worlds                                                                │
│                                                                              │
│ 0000-0000-0000-0001 | foo | public                                           │
│ 0000-0000-0000-0002 | zar | public                                           │
│ 0000-0000-0000-0003 | bar | public                                           │
│                                                                              │
│ > _                                                                          │
│                                                                              │
│                                                                              │
│                                                                              │
│                                                                              │
│                                                                              │
│                                                                              │
│                                                                              │
│                                                                              │
│                                                                              │
└──────────────────────────────────────────────────────────────────────────────┘