





-----------------------------------
..........|...|.|...|.|.|.|.|.|...|
|.--------|.|.|.|.--|.|.|.|.|.|.--|
|...|.|...|.|.|.|.......|.|.|...|.|
----|.---.|.--|.|.------|.|.|.--|.|
........|.........|.|...|.|.|.....|
--------|.--------|.|.--|.|.|.----|
................|.......|.....|.|.|
-.--|.|.----|.--|.|.-----.----|.|.|
....|.|.....|.|...|...|...|.......|
|.|.--------|.|.----|.---.|.-----.|
|.|.........|.......|.........|...|
---.|.----|.|.|.--------|.--------|
....|.....|.|.|.........|.........|
-.|--.|.--|.|--.|.--|.|.|.|--.|.|.|
..|...|...|.|...|...|.|.|.|...|.|.|
-- --.----|.|--.|.|.|--.|.|.--|.|.-----
..|.......|.|...|.|.|...|.|...|.|......
---------------------------------------





                                        [u] upload bot
[esc] go back  [spc] pause  [h] help  [1/2/3] speed